Transaction Time (CET),Transaction Category,Transaction Type,Asset Id,Asset Name,Asset Currency,Transaction Currency,Currency Pair,Exchange Rate,Transaction Amount,Trade Amount,Trade Price,Trade Quantity,Cash Balance Amount,Profit And Loss Amount,Profit And Loss Currency,Transaction Description
2022-10-03 08:58:22.023000,deposits,Sepa Deposit,,,,EUR,,,250.0,,,,250.0,,,
2022-10-03 09:08:40.170000,trades,Buy Trade,NL0011540547,ABN Amro,EUR,EUR,EUREUR,1.0,-73.1,73.104,9.138,8.0,176.9,,,Order Partial Id: e9976cd2-e51c-4a87-ad16-cd67e961df9e - 1
2022-10-03 09:08:40.171000,fees,Trading Fee,NL0011540547,ABN Amro,,EUR,,,-1.5,,,,175.4,,,Order Id: e9976cd2-e51c-4a87-ad16-cd67e961df9e
2022-10-03 09:09:07.512000,trades,Buy Trade,NL0011821202,ING,EUR,EUR,EUREUR,1.0,-78.51,78.507,8.723,9.0,96.89,,,Order Partial Id: e1f08a19-4527-47f1-827f-aeacd725acb9 - 1
2022-10-03 09:09:07.513000,fees,Trading Fee,NL0011821202,ING,,EUR,,,-1.5,,,,95.39,,,Order Id: e1f08a19-4527-47f1-827f-aeacd725acb9
2022-10-03 09:09:38.251000,fees,Trading Fee,GB00BP6MXD84,Shell,,EUR,,,-1.5,,,,16.07,,,Order Id: 4a41f445-649a-4d1b-9401-619f298768f1
2022-10-03 09:09:38.251000,trades,Buy Trade,GB00BP6MXD84,Shell,EUR,EUR,EUREUR,1.0,-77.82,77.82,25.94,3.0,17.57,,,Order Partial Id: 4a41f445-649a-4d1b-9401-619f298768f1 - 1
2022-10-03 09:09:38.336000,trades,Buy Trade,GB00BP6MXD84,Shell,EUR,EUR,EUREUR,1.0,-15.18,15.17998424,25.94,0.585196,0.89,,,Order Partial Id: 4a41f445-649a-4d1b-9401-619f298768f1 - 2
2022-11-15 08:11:34.794000,deposits,Sepa Deposit,,,,EUR,,,250.0,,,,250.89,,,
2022-11-15 09:16:04.464000,trades,Buy Trade,IE00B0M62S72,iShares Euro Dividend,EUR,EUR,EUREUR,1.0,-89.84,89.84,17.968,5.0,161.05,,,Order Partial Id: c808850b-abdd-4bc9-a9c9-68752a39e55f - 1
2022-11-15 09:16:04.465000,fees,Trading Fee,IE00B0M62S72,iShares Euro Dividend,,EUR,,,-1.5,,,,159.55,,,Order Id: c808850b-abdd-4bc9-a9c9-68752a39e55f
2022-11-15 09:16:38.104000,fees,Trading Fee,NL0011821202,ING,,EUR,,,-1.5,,,,90.11,,,Order Id: 3803d720-4d78-4988-a4d9-616532a31c22
2022-11-15 09:16:38.104000,trades,Buy Trade,NL0011821202,ING,EUR,EUR,EUREUR,1.0,-67.94,67.944,11.324,6.0,91.61,,,Order Partial Id: 3803d720-4d78-4988-a4d9-616532a31c22 - 1
2022-11-15 09:16:38.203000,trades,Buy Trade,NL0011821202,ING,EUR,EUR,EUREUR,1.0,-7.06,7.05599572,11.324,0.623101,83.05,,,Order Partial Id: 3803d720-4d78-4988-a4d9-616532a31c22 - 2
2022-11-15 09:16:56.909000,fees,Trading Fee,NL0011540547,ABN Amro,,EUR,,,-1.5,,,,2.66,,,Order Id: c2f9b930-6b26-47b0-b361-b9770f4144a7
2022-11-15 09:16:56.909000,trades,Buy Trade,NL0011540547,ABN Amro,EUR,EUR,EUREUR,1.0,-78.89,78.89,11.27,7.0,4.16,,,Order Partial Id: c2f9b930-6b26-47b0-b361-b9770f4144a7 - 1
2022-12-08 15:44:59.360000,deposits,Sepa Deposit,,,,EUR,,,250.0,,,,252.66,,,
2022-12-08 15:45:39.478000,trades,Buy Trade,NL0011540547,ABN Amro,EUR,EUR,EUREUR,1.0,-119.05,119.05,11.905,10.0,133.61,,,Order Partial Id: 30be35b0-92d6-4b84-9a09-92da00f204be - 1
2022-12-08 15:45:39.479000,fees,Trading Fee,NL0011540547,ABN Amro,,EUR,,,-1.5,,,,132.11,,,Order Id: 30be35b0-92d6-4b84-9a09-92da00f204be
2022-12-08 15:45:49.686000,trades,Buy Trade,NL0011821202,ING,EUR,EUR,EUREUR,1.0,-123.27,123.266,11.206,11.0,8.84,,,Order Partial Id: ff8bcfad-8f16-40cb-98ca-7e1dfe3a903f - 1
2022-12-08 15:45:49.688000,fees,Trading Fee,NL0011821202,ING,,EUR,,,-1.5,,,,7.34,,,Order Id: ff8bcfad-8f16-40cb-98ca-7e1dfe3a903f
2022-12-08 15:45:49.813000,trades,Buy Trade,NL0011821202,ING,EUR,EUR,EUREUR,1.0,-7.34,7.34399778,11.206,0.655363,0.0,,,Order Partial Id: ff8bcfad-8f16-40cb-98ca-7e1dfe3a903f - 2
2022-12-20 14:13:01.444000,dividends,Cash Dividend,GB00BP6MXD84,Shell,EUR,EUR,EUREUR,1.0,0.85,,,,0.85,,,
2022-12-21 11:05:21.287000,deposits,Sepa Deposit,,,,EUR,,,500.0,,,,500.85,,,
2022-12-21 11:07:26.793000,trades,Buy Trade,NL0011540547,ABN Amro,EUR,EUR,EUREUR,1.0,-155.94,155.94,12.995,12.0,344.91,,,Order Partial Id: 66af0d54-f665-45d8-a552-28e2dfbbc56e - 1
2022-12-21 11:07:26.794000,fees,Trading Fee,NL0011540547,ABN Amro,,EUR,,,-1.5,,,,343.41,,,Order Id: 66af0d54-f665-45d8-a552-28e2dfbbc56e
2022-12-21 11:07:40.612000,trades,Buy Trade,NL0011821202,ING,EUR,EUR,EUREUR,1.0,-149.08,149.084,11.468,13.0,194.33,,,Order Partial Id: 3f37c81d-9f25-4137-b8ae-f666a429b025 - 1
2022-12-21 11:07:40.613000,fees,Trading Fee,NL0011821202,ING,,EUR,,,-1.5,,,,192.83,,,Order Id: 3f37c81d-9f25-4137-b8ae-f666a429b025
2022-12-21 11:07:40.660000,trades,Buy Trade,NL0011821202,ING,EUR,EUR,EUREUR,1.0,-0.92,0.91599503,11.468,0.079874,191.91,,,Order Partial Id: 3f37c81d-9f25-4137-b8ae-f666a429b025 - 2
2022-12-21 11:07:53.237000,trades,Buy Trade,GB00BP6MXD84,Shell,EUR,EUR,EUREUR,1.0,-187.39,187.39,26.77,7.0,4.52,,,Order Partial Id: 523abb75-f9de-41ae-a97c-0d0ee763e9ee - 1
2022-12-21 11:07:53.238000,fees,Trading Fee,GB00BP6MXD84,Shell,,EUR,,,-1.5,,,,3.02,,,Order Id: 523abb75-f9de-41ae-a97c-0d0ee763e9ee
2022-12-21 11:07:53.275000,trades,Buy Trade,GB00BP6MXD84,Shell,EUR,EUR,EUREUR,1.0,-3.02,3.01997724,26.77,0.112812,0.0,,,Order Partial Id: 523abb75-f9de-41ae-a97c-0d0ee763e9ee - 2
2022-12-30 10:58:52.423000,dividends,Cash Dividend,IE00B0M62S72,iShares Euro Dividend,EUR,EUR,EUREUR,1.0,0.11,,,,0.11,,,
2023-01-16 12:58:12.678000,dividends,Cash Dividend,NL0011821202,ING,EUR,EUR,EUREUR,1.0,2.8,,,,2.91,,,
2023-01-20 08:32:31.630000,deposits,Sepa Deposit,,,,EUR,,,500.0,,,,502.91,,,
2023-01-20 09:50:48.689000,trades,Buy Trade,NL0011821202,ING,EUR,EUR,EUREUR,1.0,-245.52,245.52,12.276,20.0,257.39,,,Order Partial Id: f5e51e1a-b76a-4011-8e64-57359f56c97e - 1
2023-01-20 09:50:48.690000,fees,Trading Fee,NL0011821202,ING,,EUR,,,-1.5,,,,255.89,,,Order Id: f5e51e1a-b76a-4011-8e64-57359f56c97e
2023-01-20 09:50:48.710000,trades,Buy Trade,NL0011821202,ING,EUR,EUR,EUREUR,1.0,-4.48,4.47999116,12.276,0.364939,251.41,,,Order Partial Id: f5e51e1a-b76a-4011-8e64-57359f56c97e - 2
2023-01-20 09:51:32.416000,fees,Trading Fee,GB00BP6MXD84,Shell,,EUR,,,-1.5,,,,4.75,,,Order Id: f2bf8fb1-ff68-49dd-89b6-565c863028a5
2023-01-20 09:51:32.416000,trades,Buy Trade,GB00BP6MXD84,Shell,EUR,EUR,EUREUR,1.0,-245.16,245.16,27.24,9.0,6.25,,,Order Partial Id: f2bf8fb1-ff68-49dd-89b6-565c863028a5 - 1
2023-01-20 09:51:32.440000,trades,Buy Trade,GB00BP6MXD84,Shell,EUR,EUR,EUREUR,1.0,-4.75,4.749975,27.24,0.174375,0.0,,,Order Partial Id: f2bf8fb1-ff68-49dd-89b6-565c863028a5 - 2
2023-01-20 09:54:24.094000,deposits,Sepa Deposit,,,,EUR,,,250.0,,,,250.0,,,
2023-01-20 09:54:48.676000,trades,Buy Trade,NL0011540547,ABN Amro,EUR,EUR,EUREUR,1.0,-245.14,245.14,14.42,17.0,4.86,,,Order Partial Id: b01ece54-2e14-47b5-b20a-79707e8b5e35 - 1
2023-01-20 09:54:48.677000,fees,Trading Fee,NL0011540547,ABN Amro,,EUR,,,-1.5,,,,3.36,,,Order Id: b01ece54-2e14-47b5-b20a-79707e8b5e35
2023-02-02 11:39:34.272000,deposits,Sepa Deposit,,,,EUR,,,250.0,,,,253.36,,,
2023-02-02 11:40:14.931000,trades,Buy Trade,NL0011821202,ING,EUR,EUR,EUREUR,1.0,-241.26,241.262,12.698,19.0,12.1,,,Order Partial Id: 1796da72-a3a5-475b-a644-046c560914b0 - 1
2023-02-02 11:40:14.932000,fees,Trading Fee,NL0011821202,ING,,EUR,,,-1.5,,,,10.6,,,Order Id: 1796da72-a3a5-475b-a644-046c560914b0
2023-02-02 11:40:14.957000,trades,Buy Trade,NL0011821202,ING,EUR,EUR,EUREUR,1.0,-10.6,10.59799206,12.698,0.834619,0.0,,,Order Partial Id: 1796da72-a3a5-475b-a644-046c560914b0 - 2
2023-02-15 10:40:30.283000,deposits,Sepa Deposit,,,,EUR,,,250.0,,,,250.0,,,
2023-02-15 15:51:26.063000,trades,Buy Trade,US88160R1014,Tesla,USD,EUR,EURUSD,1.06346,-197.09,209.6,209.6,1.0,52.91,,,Order Partial Id: f54ff174-2aed-47d4-9d43-2bf34dce3b70 - 1
2023-02-15 15:51:26.089000,trades,Buy Trade,US88160R1014,Tesla,USD,EUR,EURUSD,1.06346,-52.91,56.2648144,209.6,0.268439,0.0,,,Order Partial Id: f54ff174-2aed-47d4-9d43-2bf34dce3b70 - 2
2023-02-22 11:49:31.430000,deposits,Sepa Deposit,,,,EUR,,,600.0,,,,600.0,,,
2023-02-22 11:53:33.931000,trades,Buy Trade,NL0011821202,ING,EUR,EUR,EUREUR,1.0,-193.17,193.17,12.878,15.0,406.83,,,Order Partial Id: d516f5fa-1c77-4d35-af24-b3a89355ee72 - 1
2023-02-22 11:53:33.932000,fees,Trading Fee,NL0011821202,ING,,EUR,,,-1.5,,,,405.33,,,Order Id: d516f5fa-1c77-4d35-af24-b3a89355ee72
2023-02-22 11:53:33.957000,trades,Buy Trade,NL0011821202,ING,EUR,EUR,EUREUR,1.0,-6.83,6.82998896,12.878,0.530361,398.5,,,Order Partial Id: d516f5fa-1c77-4d35-af24-b3a89355ee72 - 2
2023-02-22 11:53:43.851000,fees,Trading Fee,GB00BP6MXD84,Shell,,EUR,,,-1.5,,,,201.0,,,Order Id: 47bce3bf-993d-42bd-859a-d34fd8cca982
2023-02-22 11:53:43.851000,trades,Buy Trade,GB00BP6MXD84,Shell,EUR,EUR,EUREUR,1.0,-196.0,196.0,28.0,7.0,202.5,,,Order Partial Id: 47bce3bf-993d-42bd-859a-d34fd8cca982 - 1
2023-02-22 11:53:43.880000,trades,Buy Trade,GB00BP6MXD84,Shell,EUR,EUR,EUREUR,1.0,-4.0,3.999996,28.0,0.142857,197.0,,,Order Partial Id: 47bce3bf-993d-42bd-859a-d34fd8cca982 - 2
2023-02-22 11:53:55.698000,trades,Buy Trade,NL0011540547,ABN Amro,EUR,EUR,EUREUR,1.0,-180.51,180.51,16.41,11.0,16.49,,,Order Partial Id: 2d464546-b43f-4020-8f6b-736ecdfc8db8 - 1
2023-02-22 11:53:55.699000,fees,Trading Fee,NL0011540547,ABN Amro,,EUR,,,-1.5,,,,14.99,,,Order Id: 2d464546-b43f-4020-8f6b-736ecdfc8db8
2023-03-20 10:57:18.001000,deposits,Sepa Deposit,,,,EUR,,,1000.0,,,,1014.99,,,
2023-03-20 10:57:46.065000,trades,Buy Trade,NL0011821202,ING,EUR,EUR,EUREUR,1.0,-393.59,393.588,10.092,39.0,621.4,,,Order Partial Id: eb131c26-cedc-4e23-abb9-ec1066690c10 - 1
2023-03-20 10:57:46.066000,fees,Trading Fee,NL0011821202,ING,,EUR,,,-1.5,,,,619.9,,,Order Id: eb131c26-cedc-4e23-abb9-ec1066690c10
2023-03-20 10:57:46.105000,trades,Buy Trade,NL0011821202,ING,EUR,EUR,EUREUR,1.0,-6.41,6.41199257,10.092,0.635354,613.49,,,Order Partial Id: eb131c26-cedc-4e23-abb9-ec1066690c10 - 2
2023-03-20 10:58:11.373000,trades,Buy Trade,NL0011540547,ABN Amro,EUR,EUR,EUREUR,1.0,-402.81,402.81,13.89,29.0,210.68,,,Order Partial Id: 715c11fb-74be-4b7a-bb95-e26923129731 - 1
2023-03-20 10:58:11.375000,fees,Trading Fee,NL0011540547,ABN Amro,,EUR,,,-1.5,,,,209.18,,,Order Id: 715c11fb-74be-4b7a-bb95-e26923129731
2023-03-20 10:58:24.946000,trades,Buy Trade,GB00BP6MXD84,Shell,EUR,EUR,EUREUR,1.0,-202.08,202.08,25.26,8.0,7.1,,,Order Partial Id: 9e881627-c474-4cf9-ad87-3e6c00fa4cb7 - 1
2023-03-20 10:58:24.947000,fees,Trading Fee,GB00BP6MXD84,Shell,,EUR,,,-1.5,,,,5.6,,,Order Id: 9e881627-c474-4cf9-ad87-3e6c00fa4cb7
2023-03-20 10:58:24.971000,trades,Buy Trade,GB00BP6MXD84,Shell,EUR,EUR,EUREUR,1.0,-5.6,5.59999044,25.26,0.221694,0.0,,,Order Partial Id: 9e881627-c474-4cf9-ad87-3e6c00fa4cb7 - 2
2023-03-27 11:19:01.431000,dividends,Cash Dividend,GB00BP6MXD84,Shell,EUR,EUR,EUREUR,1.0,5.39,,,,5.39,,,
2023-03-27 16:00:42.189000,trades,Sell Trade,NL0011821202,ING,EUR,EUR,EUREUR,1.0,106.56,106.56,10.656,10.0,111.95,-6.61,EUR,Order Partial Id: a91e0c99-508c-46e0-9ad4-0dcdbd2d0faf - 1
2023-03-27 16:06:02.179000,withdrawals,Sepa Withdrawal,,,,EUR,,,-100.0,,,,11.95,,,
2023-03-28 16:00:33.100000,trades,Sell Trade,IE00B0M62S72,iShares Euro Dividend,EUR,EUR,EUREUR,1.0,82.23,82.23,16.446,5.0,94.18,-7.61,EUR,Order Partial Id: 5c91b5b1-a295-4371-b742-39fdbedac402 - 1
2023-03-28 19:14:04.713000,withdrawals,Sepa Withdrawal,,,,EUR,,,-94.18,,,,0.0,,,
2023-03-29 11:22:59.982000,dividends,Cash Dividend,IE00B0M62S72,iShares Euro Dividend,EUR,EUR,EUREUR,1.0,0.41,,,,0.41,,,
2023-04-20 16:08:49.036000,deposits,Sepa Deposit,,,,EUR,,,94.18,,,,94.59,,,
2023-04-20 16:10:22.908000,deposits,Sepa Deposit,,,,EUR,,,5.0,,,,99.59,,,
2023-04-20 16:10:45.011000,fees,Trading Fee,NL0011540547,ABN Amro,,EUR,,,-1.99,,,,3.94,,,Order Id: f1ce7204-f5d6-4def-b39f-4ae1f8d266c3
2023-04-20 16:10:45.011000,trades,Buy Trade,NL0011540547,ABN Amro,EUR,EUR,EUREUR,1.0,-93.66,93.66,15.61,6.0,5.93,,,Order Partial Id: f1ce7204-f5d6-4def-b39f-4ae1f8d266c3 - 1
2023-05-02 16:14:51.835000,fees,Subscription Fee,,,,EUR,,,-2.99,,,,0.95,,,Period: 2023-05
2023-05-05 11:38:03.307000,dividends,Cash Dividend,NL0011821202,ING,EUR,EUR,EUREUR,1.0,41.56,,,,42.51,,,
2023-05-08 10:59:54.794000,withdrawals,Sepa Withdrawal,,,,EUR,,,-42.51,,,,0.0,,,
2023-05-10 10:52:05.782000,trades,Sell Trade,NL0011540547,ABN Amro,EUR,EUR,EUREUR,1.0,100.17,100.17,14.31,7.0,100.17,5.73,EUR,Order Partial Id: 7e3c3787-e362-439c-8202-8338d212c149 - 1
2023-05-10 10:52:05.796000,fees,Trading Fee,NL0011540547,ABN Amro,,EUR,,,-1.99,,,,98.18,,,Order Id: 7e3c3787-e362-439c-8202-8338d212c149
2023-05-10 10:52:27.366000,fees,Trading Fee,NL0011821202,ING,,EUR,,,-1.99,,,,96.19,,,Order Id: 5cccbbe4-ebdc-46eb-b6ac-fb4eac321fb1
2023-05-10 10:52:27.384000,trades,Sell Trade,NL0011821202,ING,EUR,EUR,EUREUR,1.0,100.44,100.44,11.16,9.0,196.63,-1.41,EUR,Order Partial Id: 5cccbbe4-ebdc-46eb-b6ac-fb4eac321fb1 - 1
2023-05-10 10:52:39.789000,withdrawals,Sepa Withdrawal,,,,EUR,,,-196.63,,,,0.0,,,
2023-05-17 09:29:53.148000,dividends,Cash Dividend,NL0011540547,ABN Amro,EUR,EUR,EUREUR,1.0,56.95,,,,56.95,,,
2023-06-01 23:57:51.544000,fees,Subscription Fee,,,,EUR,,,-2.99,,,,53.96,,,Period: 2023-05
2023-06-26 10:39:52.561000,dividends,Cash Dividend,GB00BP6MXD84,Shell,EUR,EUR,EUREUR,1.0,9.43,,,,63.39,,,
2023-07-01 17:37:52.534000,fees,Subscription Fee,,,,EUR,,,-2.99,,,,60.4,,,Period: 2023-06
2023-07-05 21:22:14.635000,deposits,Sepa Deposit,,,,EUR,,,250.0,,,,310.4,,,
2023-07-05 21:22:57.692000,fees,Trading Fee,US30303M1027,Meta Platforms,,EUR,,,-0.99,,,,36.59,,,Order Id: 528bd238-2991-4c20-a09b-c571094e0fa2
2023-07-05 21:22:57.692000,trades,Buy Trade,US30303M1027,Meta Platforms,USD,EUR,EURUSD,1.08257,-272.82,295.35,295.35,1.0,37.58,,,Order Partial Id: 528bd238-2991-4c20-a09b-c571094e0fa2 - 1
2023-07-05 21:22:57.693000,trades,Buy Trade,US30303M1027,Meta Platforms,USD,EUR,EURUSD,1.08257,-27.29,29.535,295.35,0.1,9.3,,,Order Partial Id: 528bd238-2991-4c20-a09b-c571094e0fa2 - 2
2023-07-19 08:03:26.479000,interest,Interest Payment,,,,EUR,,,0.14,,,,9.44,,,Period: 2023 Q2
2023-08-02 00:44:56.170000,fees,Subscription Fee,,,,EUR,,,-2.99,,,,6.45,,,Period: 2023-07
2023-08-14 16:36:58.002000,dividends,Cash Dividend,NL0011821202,ING,EUR,EUR,EUREUR,1.0,34.72,,,,41.17,,,
2023-08-16 09:26:54.119000,deposits,Sepa Deposit,,,,EUR,,,500.0,,,,541.17,,,
2023-08-16 09:27:15.947000,fees,Trading Fee,NL0011540547,ABN Amro,,EUR,,,-1.99,,,,18.39,,,Order Id: 9f87933f-3674-42c0-95a3-a91e686d0d17
2023-08-16 09:27:15.947000,trades,Buy Trade,NL0011540547,ABN Amro,EUR,EUR,EUREUR,1.0,-520.79,520.79,13.705,38.0,20.38,,,Order Partial Id: 9f87933f-3674-42c0-95a3-a91e686d0d17 - 1
2023-08-22 17:53:58.644000,deposits,Sepa Deposit,,,,EUR,,,1000.0,,,,1018.39,,,
2023-08-22 17:54:16.362000,trades,Buy Trade,US0378331005,Apple,USD,EUR,EURUSD,1.08198,-489.94,530.1,176.7,3.0,528.45,,,Order Partial Id: 00ca3060-7a6a-4e42-b055-73ea6c512b9f - 1
2023-08-22 17:54:16.363000,fees,Trading Fee,US0378331005,Apple,,EUR,,,-0.99,,,,527.46,,,Order Id: 00ca3060-7a6a-4e42-b055-73ea6c512b9f
2023-08-22 17:54:16.363000,trades,Buy Trade,US0378331005,Apple,USD,EUR,EURUSD,1.08198,-10.06,10.8898443,176.7,0.061629,517.4,,,Order Partial Id: 00ca3060-7a6a-4e42-b055-73ea6c512b9f - 2
2023-08-22 17:54:28.838000,trades,Buy Trade,US30303M1027,Meta Platforms,USD,EUR,EURUSD,1.08198,-250.0,270.49490945,289.15,0.935483,267.4,,,Order Partial Id: dbc09082-886a-4eda-926c-4e0e3f03fe93 - 1
2023-08-22 17:54:28.839000,fees,Trading Fee,US30303M1027,Meta Platforms,,EUR,,,-0.99,,,,266.41,,,Order Id: dbc09082-886a-4eda-926c-4e0e3f03fe93
2023-08-22 17:54:35.443000,fees,Trading Fee,US88160R1014,Tesla,,EUR,,,-0.99,,,,51.32,,,Order Id: a9ae9b77-0ea2-4b0b-81c4-40063f00e276
2023-08-22 17:54:35.443000,trades,Buy Trade,US88160R1014,Tesla,USD,EUR,EURUSD,1.08195,-214.1,231.65,231.65,1.0,52.31,,,Order Partial Id: a9ae9b77-0ea2-4b0b-81c4-40063f00e276 - 1
2023-08-22 17:54:35.515000,trades,Buy Trade,US88160R1014,Tesla,USD,EUR,EURUSD,1.08195,-51.32,55.5209454,231.65,0.239676,0.0,,,Order Partial Id: a9ae9b77-0ea2-4b0b-81c4-40063f00e276 - 2
2023-09-12 09:57:27.146000,dividends,Cash Dividend,NL0011540547,ABN Amro,EUR,EUR,EUREUR,1.0,49.01,,,,49.01,,,
2023-09-12 09:57:27.231000,fees,Subscription Fee,,,,EUR,,,-2.99,,,,46.02,,,Period: 2023-08
2023-09-18 13:32:01.381000,dividends,Cash Dividend,GB00BP6MXD84,Shell,EUR,EUR,EUREUR,1.0,10.73,,,,56.75,,,
2023-09-20 16:26:22.828000,deposits,Sepa Deposit,,,,EUR,,,500.0,,,,556.75,,,
2023-09-20 16:26:35.618000,fees,Trading Fee,US0231351067,Amazon.com,,EUR,,,-0.99,,,,169.1,,,Order Id: 55d0e5c9-b0a6-466a-b6fc-616453c60678
2023-09-20 16:26:35.618000,trades,Buy Trade,US0231351067,Amazon.com,USD,EUR,EURUSD,1.06901,-386.66,413.34,137.78,3.0,170.09,,,Order Partial Id: 55d0e5c9-b0a6-466a-b6fc-616453c60678 - 1
2023-09-20 16:26:35.657000,trades,Buy Trade,US0231351067,Amazon.com,USD,EUR,EURUSD,1.06901,-128.88,137.78,137.78,1.0,40.22,,,Order Partial Id: 55d0e5c9-b0a6-466a-b6fc-616453c60678 - 2
2023-09-20 16:26:35.658000,trades,Buy Trade,US0231351067,Amazon.com,USD,EUR,EURUSD,1.06901,-40.22,42.9928712,137.78,0.31204,0.0,,,Order Partial Id: 55d0e5c9-b0a6-466a-b6fc-616453c60678 - 3
2023-10-05 09:01:20.085000,interest,Interest Payment,,,,EUR,,,0.08,,,,0.08,,,Period: 2023 M10
2023-10-20 15:04:20.662000,deposits,Sepa Deposit,,,,EUR,,,1000.0,,,,1000.08,,,
2023-10-20 15:04:20.676000,fees,Subscription Fee,,,,EUR,,,-2.99,,,,997.09,,,Period: 2023-09
2023-10-20 15:04:36.919000,trades,Buy Trade,NL0010773842,NN Group,EUR,EUR,EUREUR,1.0,-482.4,482.4,30.15,16.0,514.69,,,Order Partial Id: d979b0ee-27cc-4d9d-85f2-2a2f64282955 - 1
2023-10-20 15:04:36.920000,fees,Trading Fee,NL0010773842,NN Group,,EUR,,,-1.99,,,,512.7,,,Order Id: d979b0ee-27cc-4d9d-85f2-2a2f64282955
2023-10-20 15:04:36.976000,trades,Buy Trade,NL0010773842,NN Group,EUR,EUR,EUREUR,1.0,-17.6,17.59997205,30.15,0.583747,495.1,,,Order Partial Id: d979b0ee-27cc-4d9d-85f2-2a2f64282955 - 2
2023-10-20 15:06:08.931000,fees,Trading Fee,IE00B3XXRP09,Vanguard S&P 500,,EUR,,,-1.99,,,,34.89,,,Order Id: 2fd72117-03c3-43ac-98c3-11ced8f53e1f
2023-10-20 15:06:08.931000,trades,Buy Trade,IE00B3XXRP09,Vanguard S&P 500,EUR,EUR,EUREUR,1.0,-458.22,458.22,76.37,6.0,36.88,,,Order Partial Id: 2fd72117-03c3-43ac-98c3-11ced8f53e1f - 1
2023-10-20 15:06:08.932000,trades,Buy Trade,IE00B3XXRP09,Vanguard S&P 500,EUR,EUR,EUREUR,1.0,-34.89,34.88993998,76.37,0.456854,0.0,,,Order Partial Id: 2fd72117-03c3-43ac-98c3-11ced8f53e1f - 2
2023-11-08 16:20:27.355000,deposits,Sepa Deposit,,,,EUR,,,500.0,,,,500.0,,,
2023-11-08 16:20:27.367000,fees,Subscription Fee,,,,EUR,,,-2.99,,,,497.01,,,Period: 2023-10
2023-11-08 16:20:44.107000,trades,Buy Trade,NL0011540547,ABN Amro,EUR,EUR,EUREUR,1.0,-487.0,487.0,12.175,40.0,10.01,,,Order Partial Id: 3dac6c63-30fe-4262-99f5-5b8281dbfcad - 1
2023-11-08 16:20:44.108000,fees,Trading Fee,NL0011540547,ABN Amro,,EUR,,,-1.99,,,,8.02,,,Order Id: 3dac6c63-30fe-4262-99f5-5b8281dbfcad
2023-11-20 14:45:15.928000,dividends,Cash Dividend,US0378331005,Apple,USD,EUR,EURUSD,1.09544,0.55,,,,8.57,,,
2023-11-22 21:50:16.153000,deposits,Sepa Deposit,,,,EUR,,,500.0,,,,508.57,,,
2023-11-23 09:14:02.402000,trades,Buy Trade,NL0010273215,ASML,EUR,EUR,EUREUR,1.0,-506.58,506.579441,628.3,0.80627,1.99,,,Order Partial Id: c3ff1661-c79a-4f3f-a5e7-14faecf5c3a9 - 1
2023-11-23 09:14:02.403000,fees,Trading Fee,NL0010273215,ASML,,EUR,,,-1.99,,,,0.0,,,Order Id: c3ff1661-c79a-4f3f-a5e7-14faecf5c3a9
2023-12-05 07:12:58.935000,interest,Interest Payment,,,,EUR,,,0.05,,,,0.05,,,Period: 2023 M11
2023-12-20 15:42:32.051000,dividends,Cash Dividend,GB00BP6MXD84,Shell,EUR,EUR,EUREUR,1.0,10.81,,,,10.86,,,
2023-12-20 15:42:32.143000,fees,Subscription Fee,,,,EUR,,,-2.99,,,,7.87,,,Period: 2023-11
2023-12-27 10:24:19.727000,dividends,Cash Dividend,IE00B3XXRP09,Vanguard S&P 500,USD,EUR,EURUSD,1.10777,1.62,,,,9.49,,,
2024-01-01 12:46:48.316000,fees,Subscription Fee,,,,EUR,,,-2.99,,,,6.5,,,Period: 2023-12
2024-01-05 07:32:31.705000,interest,Interest Payment,,,,EUR,,,0.01,,,,6.51,,,Period: 2023 M12
2024-02-01 11:49:27.664000,deposits,Sepa Deposit,,,,EUR,,,500.0,,,,506.51,,,
2024-02-01 11:49:48.747000,fees,Trading Fee,NL0011821202,ING,,EUR,,,-1.99,,,,8.34,,,Order Id: fc72815e-cbe8-425a-8b54-34ca5a78a375
2024-02-01 11:49:48.747000,trades,Buy Trade,NL0011821202,ING,EUR,EUR,EUREUR,1.0,-496.18,496.182,12.102,41.0,10.33,,,Order Partial Id: fc72815e-cbe8-425a-8b54-34ca5a78a375 - 1
2024-02-01 11:49:48.748000,trades,Buy Trade,NL0011821202,ING,EUR,EUR,EUREUR,1.0,-8.34,8.33799965,12.102,0.688977,0.0,,,Order Partial Id: fc72815e-cbe8-425a-8b54-34ca5a78a375 - 2
2024-02-05 07:42:55.452000,interest,Interest Payment,,,,EUR,,,0.01,,,,0.01,,,Period: 2024 M1
2024-02-14 10:28:55.522000,dividends,Cash Dividend,NL0010273215,ASML,EUR,EUR,EUREUR,1.0,0.98,,,,0.99,,,
2024-02-15 11:27:12.315000,dividends,Cash Dividend,US0378331005,Apple,USD,EUR,EURUSD,1.076,0.56,,,,1.55,,,
2024-03-25 11:34:01.499000,dividends,Cash Dividend,GB00BP6MXD84,Shell,EUR,EUR,EUREUR,1.0,11.09,,,,12.64,,,
2024-03-25 11:34:01.559000,fees,Subscription Fee,,,,EUR,,,-2.99,,,,9.65,,,Period: 2024-01
2024-03-25 11:34:01.560000,fees,Subscription Fee,,,,EUR,,,-2.99,,,,6.66,,,Period: 2024-02
2024-03-27 14:50:21.256000,dividends,Cash Dividend,US30303M1027,Meta Platforms,USD,EUR,EURUSD,1.08587,0.78,,,,7.44,,,
2024-03-27 14:56:16.202000,dividends,Cash Dividend,IE00B3XXRP09,Vanguard S&P 500,USD,EUR,EURUSD,1.08609,1.79,,,,9.23,,,
2024-04-01 13:02:30.349000,fees,Subscription Fee,,,,EUR,,,-2.99,,,,6.24,,,Period: 2024-03
2024-04-05 08:00:12.373000,interest,Interest Payment,,,,EUR,,,0.01,,,,6.25,,,Period: 2024 M3
2024-04-23 09:46:47.646000,deposits,Sepa Deposit,,,,EUR,,,500.0,,,,506.25,,,
2024-04-23 09:47:05.360000,trades,Buy Trade,NL0010273215,ASML,EUR,EUR,EUREUR,1.0,-504.26,504.2597672,821.8,0.613604,1.99,,,Order Partial Id: 07a5f189-cf50-4783-a3da-00e3ab7db6fb - 1
2024-04-23 09:47:05.361000,fees,Trading Fee,NL0010273215,ASML,,EUR,,,-1.99,,,,0.0,,,Order Id: 07a5f189-cf50-4783-a3da-00e3ab7db6fb
2024-05-03 11:27:12.855000,dividends,Cash Dividend,NL0011821202,ING,EUR,EUR,EUREUR,1.0,101.78,,,,101.78,,,
2024-05-03 11:27:12.855000,fees,Subscription Fee,,,,EUR,,,-2.99,,,,98.79,,,Period: 2024-04
2024-05-05 08:44:16.737000,interest,Interest Payment,,,,EUR,,,0.01,,,,98.8,,,Period: 2024 M4
2024-05-07 09:12:30.484000,dividends,Cash Dividend,NL0010273215,ASML,EUR,EUR,EUREUR,1.0,2.1,,,,100.9,,,
2024-05-17 11:48:52.124000,dividends,Cash Dividend,US0378331005,Apple,USD,EUR,EURUSD,1.08695,0.58,,,,101.48,,,
2024-05-22 10:54:23.486000,deposits,Sepa Deposit,,,,EUR,,,500.0,,,,601.48,,,
2024-05-22 12:14:41.708000,trades,Buy Trade,FR001400J770,Air France-KLM,EUR,EUR,EUREUR,1.0,-590.24,590.24,10.54,56.0,11.24,,,Order Partial Id: 53fe7e6b-72f3-428c-998b-a8d6ffbd37ea - 1
2024-05-22 12:14:41.709000,fees,Trading Fee,FR001400J770,Air France-KLM,,EUR,,,-1.99,,,,7.47,,,Order Id: 53fe7e6b-72f3-428c-998b-a8d6ffbd37ea
2024-05-22 12:14:41.709000,tax,Financial Transaction Tax,FR001400J770,Air France-KLM,,EUR,,,-1.78,,,,9.46,,,
2024-05-27 11:11:23.572000,dividends,Cash Dividend,NL0011540547,ABN Amro,EUR,EUR,EUREUR,1.0,129.36,,,,136.83,,,
2024-06-01 19:46:34.549000,fees,Subscription Fee,,,,EUR,,,-2.99,,,,133.84,,,Period: 2024-05
2024-06-05 08:14:51.752000,interest,Interest Payment,,,,EUR,,,0.19,,,,134.03,,,Period: 2024 M5
2024-06-05 16:00:10.492000,trades,Buy Trade,NL0011794037,Ahold,EUR,EUR,EUREUR,1.0,-114.88,114.88,28.72,4.0,19.15,,,Order Partial Id: c67582d3-46e8-43f9-8458-f14801a7e5ff - 1
2024-06-21 11:41:37.394000,dividends,Cash Dividend,NL0010773842,NN Group,EUR,EUR,EUREUR,1.0,29.31,,,,48.46,,,
2024-06-25 14:31:24.407000,dividends,Cash Dividend,GB00BP6MXD84,Shell,EUR,EUR,EUREUR,1.0,11.15,,,,59.61,,,
2024-06-26 13:19:07.172000,dividends,Cash Dividend,IE00B3XXRP09,Vanguard S&P 500,USD,EUR,EURUSD,1.07208,1.55,,,,61.16,,,
2024-06-26 13:27:43.344000,dividends,Cash Dividend,US30303M1027,Meta Platforms,USD,EUR,EURUSD,1.07245,0.79,,,,61.95,,,
2024-07-01 13:02:28.414000,fees,Subscription Fee,,,,EUR,,,-2.99,,,,58.96,,,Period: 2024-06
2024-07-05 08:01:41.426000,interest,Interest Payment,,,,EUR,,,0.11,,,,59.07,,,Period: 2024 M6
2024-08-01 13:02:28.625000,fees,Subscription Fee,,,,EUR,,,-2.99,,,,56.08,,,Period: 2024-07
2024-08-05 09:15:37.852000,interest,Interest Payment,,,,EUR,,,0.12,,,,56.2,,,Period: 2024 M7
2024-08-07 10:42:59.581000,dividends,Cash Dividend,NL0010273215,ASML,EUR,EUR,EUREUR,1.0,1.82,,,,58.02,,,
2024-08-12 09:53:47.293000,dividends,Cash Dividend,NL0011821202,ING,EUR,EUR,EUREUR,1.0,47.12,,,,105.14,,,
2024-08-15 10:13:32.561000,dividends,Cash Dividend,US0378331005,Apple,USD,EUR,EURUSD,1.10389,0.57,,,,105.71,,,
2024-08-27 09:35:40.545000,dividends,Cash Dividend,NL0010773842,NN Group,EUR,EUR,EUREUR,1.0,18.03,,,,123.74,,,
2024-08-28 08:01:21.149000,withdrawals,Sepa Withdrawal,,,,EUR,,,-120.0,,,,3.74,,,
2024-08-29 10:42:28.136000,dividends,Cash Dividend,NL0011794037,Ahold,EUR,EUR,EUREUR,1.0,1.7,,,,5.44,,,
2024-09-02 09:32:09.696000,interest,Interest Payment,,,,EUR,,,0.16,,,,5.6,,,Period: 2024 M8
2024-09-02 12:04:51.886000,fees,Subscription Fee,,,,EUR,,,-2.99,,,,2.61,,,Period: 2024-08
2024-09-03 18:32:11.689000,fees,Trading Fee,US88160R1014,Tesla,,EUR,,,-0.99,,,,1.62,,,Order Id: fc3c459d-5e8a-4588-982e-8a5bbbf1774b
2024-09-03 18:32:11.716000,trades,Sell Trade,US88160R1014,Tesla,USD,EUR,EURUSD,1.10715,388.75,430.4,215.2,2.0,390.37,-22.25,EUR,Order Partial Id: fc3c459d-5e8a-4588-982e-8a5bbbf1774b - 1
2024-09-03 18:32:11.745000,trades,Sell Trade,US88160R1014,Tesla,USD,EUR,EURUSD,1.10715,98.76,109.346348,215.2,0.508115,489.13,-5.66,EUR,Order Partial Id: fc3c459d-5e8a-4588-982e-8a5bbbf1774b - 2
2024-09-03 18:32:40.631000,withdrawals,Sepa Withdrawal,,,,EUR,,,-155.0,,,,334.13,,,
2024-09-04 11:16:35.871000,trades,Buy Trade,NL0010273215,ASML,EUR,EUR,EUREUR,1.0,-332.14,332.1398732,741.2,0.448111,1.99,,,Order Partial Id: 86345c6b-b61e-4d3b-a042-986c8e6a041f - 1
2024-09-04 11:16:35.872000,fees,Trading Fee,NL0010273215,ASML,,EUR,,,-1.99,,,,0.0,,,Order Id: 86345c6b-b61e-4d3b-a042-986c8e6a041f
2024-09-11 14:59:58.061000,dividends,Cash Dividend,NL0011540547,ABN Amro,EUR,EUR,EUREUR,1.0,87.21,,,,87.21,,,
2024-09-24 10:39:26.062000,dividends,Cash Dividend,GB00BP6MXD84,Shell,EUR,EUR,EUREUR,1.0,10.93,,,,98.14,,,
2024-09-25 11:54:38.530000,dividends,Cash Dividend,IE00B3XXRP09,Vanguard S&P 500,USD,EUR,EURUSD,1.1219,1.63,,,,99.77,,,
2024-09-26 12:02:36.218000,dividends,Cash Dividend,US30303M1027,Meta Platforms,USD,EUR,EURUSD,1.1166,0.76,,,,100.53,,,
2024-09-27 14:08:18.837000,deposits,Sepa Deposit,,,,EUR,,,275.0,,,,375.53,,,
2024-09-27 14:08:36.782000,trades,Buy Trade,NL0009739416,PostNL,EUR,EUR,EUREUR,1.0,-371.32,371.322,1.263,294.0,4.21,,,Order Partial Id: c5de9fe4-5eff-4906-80c0-331817a044cf - 1
2024-09-27 14:08:36.783000,fees,Trading Fee,NL0009739416,PostNL,,EUR,,,-1.99,,,,2.22,,,Order Id: c5de9fe4-5eff-4906-80c0-331817a044cf
2024-09-27 14:08:36.949000,trades,Buy Trade,NL0009739416,PostNL,EUR,EUR,EUREUR,1.0,-2.22,2.21799977,1.263,1.756136,0.0,,,Order Partial Id: c5de9fe4-5eff-4906-80c0-331817a044cf - 2
2024-10-07 08:26:09.688000,interest,Interest Payment,,,,EUR,,,0.13,,,,0.13,,,Period: 2024 M9
2024-11-07 10:57:25.577000,dividends,Cash Dividend,NL0010273215,ASML,EUR,EUR,EUREUR,1.0,2.4,,,,2.53,,,
2024-11-14 11:24:04.253000,dividends,Cash Dividend,US0378331005,Apple,USD,EUR,EURUSD,1.05449,0.6,,,,3.13,,,
2024-11-14 11:24:04.254000,fees,Subscription Fee,,,,EUR,,,-2.99,,,,0.14,,,Period: 2024-09
2024-11-18 15:33:52.106000,trades,Sell Trade,US0231351067,Amazon.com,USD,EUR,EURUSD,1.05927,383.64,406.38,203.19,2.0,383.78,125.87,EUR,Order Partial Id: dc03bb9e-798f-45aa-9c32-fe6905ced383 - 1
2024-11-18 15:33:52.107000,fees,Subscription Fee,,,,EUR,,,-2.99,,,,380.79,,,Period: 2024-10
2024-11-18 15:33:52.108000,fees,Trading Fee,US0231351067,Amazon.com,,EUR,,,-0.99,,,,379.8,,,Order Id: dc03bb9e-798f-45aa-9c32-fe6905ced383
2024-11-18 15:33:52.196000,trades,Sell Trade,US0231351067,Amazon.com,USD,EUR,EURUSD,1.05927,29.93,31.7017038,203.19,0.15602,409.73,9.82,EUR,Order Partial Id: dc03bb9e-798f-45aa-9c32-fe6905ced383 - 2
2024-11-18 15:34:02.715000,withdrawals,Sepa Withdrawal,,,,EUR,,,-409.0,,,,0.73,,,
2024-11-18 15:34:18.486000,withdrawals,Sepa Withdrawal,,,,EUR,,,-0.7,,,,0.03,,,
2024-11-20 20:48:56.374000,fees,Trading Fee,US30303M1027,Meta Platforms,,EUR,,,-0.99,,,,199.97,,,Order Id: 90b35d55-0253-44c2-afe3-aba8820c2b61
2024-11-20 20:48:56.374000,trades,Sell Trade,US30303M1027,Meta Platforms,USD,EUR,EURUSD,1.05681,200.93,212.34906,561.77,0.378,200.96,98.77,EUR,Order Partial Id: 90b35d55-0253-44c2-afe3-aba8820c2b61 - 1
2024-11-20 20:49:09.297000,withdrawals,Sepa Withdrawal,,,,EUR,,,-199.97,,,,0.0,,,
2024-12-19 11:06:08.830000,dividends,Cash Dividend,GB00BP6MXD84,Shell,EUR,EUR,EUREUR,1.0,11.49,,,,11.49,,,
2024-12-19 11:06:08.831000,fees,Subscription Fee,,,,EUR,,,-2.99,,,,8.5,,,Period: 2024-11
2024-12-27 10:25:42.601000,dividends,Cash Dividend,US30303M1027,Meta Platforms,USD,EUR,EURUSD,1.04387,0.66,,,,9.16,,,
2024-12-27 11:43:45.474000,dividends,Cash Dividend,IE00B3XXRP09,Vanguard S&P 500,USD,EUR,EURUSD,1.04418,1.88,,,,11.04,,,
2025-01-01 09:11:24.166000,fees,Subscription Fee,,,,EUR,,,-2.99,,,,8.05,,,Period: 2024-12
2025-01-16 11:08:35.400000,dividends,Cash Dividend,NL0011821202,ING,EUR,EUR,EUREUR,1.0,21.67,,,,29.72,,,
2025-02-01 09:25:08.840000,fees,Subscription Fee,,,,EUR,,,-2.99,,,,26.73,,,Period: 2025-01
2025-02-06 07:27:31.062000,interest,Interest Payment,,,,EUR,,,0.04,,,,26.77,,,Period: 2025 M1
2025-02-13 10:27:03.788000,dividends,Cash Dividend,US0378331005,Apple,USD,EUR,EURUSD,1.04391,0.61,,,,27.38,,,
2025-02-19 11:06:36.755000,dividends,Cash Dividend,NL0010273215,ASML,EUR,EUR,EUREUR,1.0,2.4,,,,29.78,,,
2025-03-01 09:11:22.806000,fees,Subscription Fee,,,,EUR,,,-2.99,,,,26.79,,,Period: 2025-02
2025-03-06 07:27:46.574000,interest,Interest Payment,,,,EUR,,,0.02,,,,26.81,,,Period: 2025 M2
2025-03-17 16:46:29.820000,others,Security Lending Revenue,,,EUR,EUR,EUREUR,1.0,0.21,,,,27.02,,,
2025-03-19 08:46:52.568000,deposits,Sepa Deposit,,,,EUR,,,250.0,,,,277.02,,,
2025-03-19 09:11:32.452000,trades,Buy Trade,GB00BP6MXD84,Shell,EUR,EUR,EUREUR,1.0,-260.84,260.84,32.605,8.0,16.18,,,Order Partial Id: 5eda88eb-3055-407d-959f-c015780aade7 - 1
2025-03-19 09:11:32.453000,fees,Trading Fee,GB00BP6MXD84,Shell,,EUR,,,-1.99,,,,14.19,,,Order Id: 5eda88eb-3055-407d-959f-c015780aade7
2025-03-19 09:11:32.620000,trades,Buy Trade,GB00BP6MXD84,Shell,EUR,EUR,EUREUR,1.0,-11.41,11.41175,32.605,0.35,2.78,,,Order Partial Id: 5eda88eb-3055-407d-959f-c015780aade7 - 2
2025-03-21 13:21:01.016000,deposits,Sepa Deposit,,,,EUR,,,250.0,,,,252.78,,,
2025-03-21 13:21:23.659000,fees,Trading Fee,IE000YYE6WK5,VanEck Defense,,EUR,,,-1.99,,,,4.22,,,Order Id: c2c99183-a477-49c9-9e26-a650f889d604
2025-03-21 13:21:23.659000,trades,Buy Trade,IE000YYE6WK5,VanEck Defense,EUR,EUR,EUREUR,1.0,-246.57,246.57,41.095,6.0,6.21,,,Order Partial Id: c2c99183-a477-49c9-9e26-a650f889d604 - 1
2025-03-25 14:16:48.429000,dividends,Cash Dividend,GB00BP6MXD84,Shell,EUR,EUR,EUREUR,1.0,11.68,,,,15.9,,,
2025-03-26 13:38:58.071000,dividends,Cash Dividend,US30303M1027,Meta Platforms,USD,EUR,EURUSD,1.08191,0.67,,,,16.57,,,
2025-04-01 10:23:17.569000,fees,Subscription Fee,,,,EUR,,,-2.99,,,,13.58,,,Period: 2025-03
2025-04-02 13:31:56.191000,dividends,Cash Dividend,IE00B3XXRP09,Vanguard S&P 500,USD,EUR,EURUSD,1.08299,1.91,,,,15.49,,,
2025-04-07 08:16:24.826000,interest,Interest Payment,,,,EUR,,,0.03,,,,15.52,,,Period: 2025 M3
2025-04-08 09:35:21.975000,deposits,Sepa Deposit,,,,EUR,,,300.0,,,,315.52,,,
2025-04-08 09:35:58.522000,trades,Buy Trade,GB00BP6MXD84,Shell,EUR,EUR,EUREUR,1.0,-283.0,283.0,28.3,10.0,32.52,,,Order Partial Id: e43f9e8e-b54c-4a2a-b682-98eb898a65ca - 1
2025-04-08 09:35:58.523000,fees,Trading Fee,GB00BP6MXD84,Shell,,EUR,,,-1.99,,,,30.53,,,Order Id: e43f9e8e-b54c-4a2a-b682-98eb898a65ca
2025-04-08 09:35:58.687000,trades,Buy Trade,GB00BP6MXD84,Shell,EUR,EUR,EUREUR,1.0,-27.45,27.451,28.3,0.97,3.08,,,Order Partial Id: e43f9e8e-b54c-4a2a-b682-98eb898a65ca - 2
2025-04-08 10:59:56.513000,fees,Trading Fee,NL0011794037,Ahold,,EUR,,,-1.99,,,,1.09,,,Order Id: 90a553c0-0f41-402f-b9aa-5f7b5ff51ac7
2025-04-08 10:59:56.536000,trades,Sell Trade,NL0011794037,Ahold,EUR,EUR,EUREUR,1.0,131.56,131.56,32.89,4.0,132.65,16.68,EUR,Order Partial Id: 90a553c0-0f41-402f-b9aa-5f7b5ff51ac7 - 1
2025-04-08 11:00:09.972000,trades,Buy Trade,GB00BP6MXD84,Shell,EUR,EUR,EUREUR,1.0,-114.3,114.3,28.575,4.0,18.35,,,Order Partial Id: e4e6fd0e-9de9-4327-8cb4-f09dc4436820 - 1
2025-04-08 11:00:09.973000,fees,Trading Fee,GB00BP6MXD84,Shell,,EUR,,,-1.99,,,,16.36,,,Order Id: e4e6fd0e-9de9-4327-8cb4-f09dc4436820
2025-04-08 11:00:10.015000,trades,Buy Trade,GB00BP6MXD84,Shell,EUR,EUR,EUREUR,1.0,-14.86,14.859,28.575,0.52,1.5,,,Order Partial Id: e4e6fd0e-9de9-4327-8cb4-f09dc4436820 - 2
